
EA assets/textr/east.png
NO assets/textr/north.png
WE assets/textr/west.png
SO assets/textr/south.png
F 220,100,0
C 225,30,0
                                  11111             
                                  10001               
                           111111110S011111111               
                                  10001            
                                  11111                     
