
EA assets/textr/east.png
NO assets/textr/north.png
WE assets/textr/west.png
SO assets/textr/south.png
F 220,100,0
C 225,30,0






    111111
    1W0001
    100001
    100001
    111111

