
EA assets/textr/east.png
NO assets/textr/north.png
WE assets/textr/west.png
SO assets/textr/south.png
F 220,100,0
C 225,30,0






    1111111111111111111111111
    1W00000000000000000000001
    1111111111111111111111111

