EA assets/_the_scream.png
NO assets/girl_with_a_pearl_earring.png
WE assets/Mona_Lisa.png
SO assets/the_starry_night.png

F 220, 100, 0
C 225,  30, 0

101111
100001
10N001
100001
111111
