EA assets/_the_scream.png
NO assets/girl_with_a_pearl_earring.png
WE assets/Mona_Lisa.png
SO assets/the_starry_night.png

F 0, 0, 0
C 255, 255, 255

11111
1x001
10N01
10001
11111
