EA assets/_the_scream.png
NO assets/girl_with_a_pearl_earring.png
WE assets/Mona_Lisa.png
SO assets/the_starry_night.png

D 220, 100, 0
C 225,  30, 0

111111
100001
10S001
100001
111111
