
EA              assets/scream.png
NO assets/girl.png
WE assets/monalisa.png
SO assets/night.png
F   40,20,0
C  200     , 200   ,200


    1111111111111111111111111 11111111
    1S00000000110000000000001  10000001
    1011000001110000000000001  11111111
    1001000000000000000000001
    111110110110000111000000011
    100000000011000001110111111111111
11110111111111011100000010001
11110111111111011101010 10001
111111111111111111111111111111
111111111111111111111111111111
11000000110101011100000010001 11111111
0000000000000001100000010001  10000001
1000000000000000001010010001 11111111
1100000111010101111101111000111
11110111 1110101 101111010001
11111111 1111111 1111111111111

1111111111111111111111111
1000000           10000001
11111111111111111111111111
